'E Arbëreshë o Arbereschi so' na pupulazione 'e circa 100.000 perzone 'e lengua arbanese ca campa 'int' ll'Italia meridiunale. Lloro se spustono 'int' Italia nfra 'o XV e 'o XVIII seculo, ncoppattutto aroppo 'a morte 'e ll'aroe nazionale arbanese Giorgio Castriota Skanderbeg.  'Int'ô corso d’’e secule 'e arbëreshë so riuscite a tenè e a sviluppà 'a propia identità arbanese, grazzie pure ô ruolo culturale esercitato d’’a doje Istitute religiose 'e rito orientale, cu sede 'int' Calavrea ('O Collegio Corsini (1732) e po' Corsini-Sant'Adriano (1794) e 'int' Sicilia (Semminario grieco-arbanese 'e Palermo (1735) po' spustato a Piana d’’e Arbanese (1945). 'A gran parte d’’e comunetà arbëreshe cunzervano ancora 'o rito grieco-bizantino


== Elenco cumpleto d''e 50 comunetà Arbëreshë ==


=== Abruzzo ===
Pruvincia 'e Pescara
Villa Badessa (frazzione 'e Rosciano): Badhesa


=== Mulise ===
Pruvincia 'e Cambuasce
Campomarino: Këmarini
Montecilfone: Munxhufuni
Portocannone: Portkanuni
Ururi: Rùri


=== Campania ===
Pruvincia 'e Avellino
Greci: Katundi


=== Pùglia ===
Pruvincia 'e Foggia
Casalvecchio di Puglia: Kazallveqi
Chieuti: Qefti
Pruvincia 'e Taranto
San Marzano di San Giuseppe: Shën Marcani


=== Baselecata ===
Pruvincia 'e Putenza
Barile: Barilli
Ginestra: Zhura
Maschito: Mashqiti
San Costantino Albanese: Shën Kostandini
San Paolo Albanese: Shën Pali


=== Calavrea ===
Pruvincia 'e Catanzaro
Andali: Andalli
Caraffa di Catanzaro: Garafa
Gizzeria: Jaceria
Marcedusa: Marçëdhuza
Vena di Maida (frazzione 'e Maida): Vina
Zangarona (frazzione 'e Lamezia Terme): Xingarona
Pruvincia 'e Cusenza
Acquaformosa: Firmoza
Cantinella (frazzione 'e Corigliano Calabro): Kantinela
Cerzeto: Qana
Castroregio: Kastërnexhi
Cavallerizzo (frazzione 'e Cerzeto): Kajverici
Civita: Çifti
Eianina (frazzione 'e Frascineto): Purçìll
Falconara Albanese: Fullkunara
Farneta (frazzione 'e Castroregio): Farneta
Firmo: Ferma
Frascineto: Frasnita
Lungro: Ungra
Macchia Albanese (frazzione 'e San Demetrio Corone): Maqi
Marri (frazzione 'e San Benedetto Ullano): Allimarri
Plataci: Pllatëni
San Basile: Shën Vasili
San Benedetto Ullano: Shën Benedhiti
Santa Caterina Albanese: Picilia
San Cosmo Albanese: Strihàri
San Demetrio Corone: Shën Mitri
San Giorgio Albanese: Mbuzati
San Giacomo di Cerzeto (frazzione 'e Cerzeto): Shën Japku
San Martino di Finita: Shën Mërtiri
Santa Sofia d'Epiro: Shën Sofia
Spezzano Albanese: Spixana
Vaccarizzo Albanese: Vakarici
Pruvincia 'e Crotone
Carfizzi: Karfici
Pallagorio: Puhëriu
San Nicola dell'Alto: Shën Kolli


=== Sicilia ===
Pruvincia 'e Palermo
Contessa Entellina: Kundisa
Piana degli Albanesi: Hora e Arbëreshëvet
Santa Cristina Gela: Sëndahstina