Бухарест (рум. București ХФӘ: [bukuˈreʃtʲ]) — Румыниядағы қала, ел астанасы, ірі өнеркәсіп орталығы.


== Тарихы ==


=== Бухарестте бекітілген келісім-шарттар ===
Мамырдың 28, 1812 жыл, Орыс-түрік соғысы аяғындағы шарт
Наурыздың 3, 1886 жыл, Серб-бұлғар соғысы аяғындағы шарт
Тамыздың 10, 1913 жыл, Екінші Балкан соғысы аяғындағы шарт
Тамыздың 4, 1916 жыл, Румыния мен Антанта үштігі арасындағы одақтық келісім
Мамырдың 6, 1918 жыл, Румыния мен Орталық Күштер арасындағы шарт


== Географиясы ==


== Халқы ==


=== Атақты тұрғындары ===
Александра Мария Лара — неміс әртісі
Адольф Албин — шахматшы
Мирча Абдулеску — әртіс
Тудор Аргези — поэт, дат жазушысы
Колетт Авитал — израиль парламенттінің мүшесі
Николай Бэлческу — тарихшы, жазушы және революционер
Генри Коандэ — өнертапқыш
Ион Дука — Румынияның 1933 жылғы премьер министрі
Мирча Элиаде — жазушы, дін тарихшысы
Мирча Джеоана — румын саясаткері, Румын социал-демократтық партиясының бастығы
Джон Хаузмэн — әртіс және продюсер
Мартин Кармиц — француз кинорежисеры және продюсер
Алекс Козински — американ төрешісі және эссеист
Дину Липатти — румын пианошысы
Герасим Лука — румындық ақын-сюрреалисті
Георгий Маринеску — невролог, румын неврология мектебінің қалаушысы
Майя Моргенстерн — румын әртісі
Адриан Нэстасе — қазіргі замандағы румын саясаткері
Илья Нэстасе — румын теннисшісі
Николай Паулеску — румынский физиолог, один из создателей инсулина
Эдвард Робинсон — американ әртісі
Джордже Топырчану — румын ақыны және әзілқойы
Корнелиу Вадим Тудор — румын саясаткері, Ұлы Румыния Партиясының бастығы
Ричард Вурмбранд — жазушы
Михаэль (Майкл) Крету — композитор, продюсер, Enigma тобының қалаушысы, Сандра Кретунің күйеуі


== Өнеркәсібі ==


== Оқу орындары ==


== Тарихи ескерткіштері ==


== Дереккөздер ==