Рязанень ёнкс (руз. Рязанская область) — ашти Россия Масторсо. Прявтошось — Эрязань ош.
Рязанень ёнксось шабрацек ашти Олодимэрэнь, Алоошонь, Пензань, Томбамонь, Липецэнь, Тулань ёнксстнень ды Мордовия марто.


== Административно-территориальной состав (ошонь кужот ды муниципальной буетне) ==


=== Ёнксонь тешкстэнь ошт ===
Касимов ош - Касимбуе
Эрязань ош - Эрязань буе
Сасово ош - Сасовонь буе
Скопин ош - Скопинень буе


=== Эрязанень ёнксонь буетне ===
Александро-Невской оков - Александро-Невской буе
Ермишь оков - Ермишень буе
Захарово оков - Захаровонь буе
Кадом оков - Кадомонь буе
Спас-Клепики ош - Клепикень буе
Кораблино ош - Кораблинень буе
Милославское ош - Милославской буе
Михайлов ош - Михайловонь буе
Пителино оков - Пителинень буе
Пронской оков - Пронской буе
Путятино веле - Путятинень буе
Рыбное ош - Рыбновонь буе
Ряжской ош - Ряжской буе
Сапожок ош - Сапожоконь буе
Сараи оков - Сараень буе
Спасск-Рязанской ош - Спасской буе
Старожилово оков - Старожиловонь буе
Ухолово оков - Ухоловонь буе
Чучково оков - Чучковонь буе
Шацкой ош - Шацкой буе
Шилово оков - Шиловонь буе


== Эрицятнеде ==


=== Эрицятнень ламочист ===
Эрязань буень эрицятне (Росстата) ули 1 108 847 лом. (2020). Плотность населения — ЛопаПарцун:ПлотностьНаселенияРегионы лом./вп² (2020). Ошонь эрицят — ЛопаПарцун:ГородскоеПроцентРегионы % (ЛопаПарцун:ГородскоеНаселениеРегионы).

Раськень состав


== Лисьмапрят ==