Big Jake (euskaraz Jake Handia), 1971ko George Sherman estatubatuarrak zuzendutako western film bat da. John Wayne, Richard Boone, Maureen O'Hara, Patrick Wayne, Christopher Mitchum eta Bruce Cabot aktoreek antzeztu zuten.


== Argumentua ==

1909, Texas, AEB, badira 19 urte Big Jack McCandlesek (John Wayne) bere emazte Martha (Maureen O'Hara) ikusten ez duela, baina etxera itzultzean gaizkile talde batek Little Jack (Ethan Wayne) biloba bahituko du. Legearen zerbitzariek gaizkile bahitzaileak erdipurdiko auto batzuetan jarraitzen dituzten bitartean, Jackek zaldiz eta Sam Sharpnose (Bruce Cabot) apatxearen laguntzaz jarraituko ditu, gainera berarekin batera dirua darama, baina Jackek ez du bahitzaileei erreskaterik ordaintzeko inolako asmorik.


== Aktoreak ==
John Wayne: Jacob McCandles
Richard Boone: John Fain
Maureen O'Hara: Martha McCandles
Patrick Wayne: James McCandles
Christopher Mitchum: Michael McCandles
Bruce Cabot: Sam Sharpnose
Bobby Vinton: Jeff McCandles
Glenn Corbett: O'Brien, edo Breed
John Doucette: Buck Duggan kapitaina, Texas rangerra
Jim Davis: Lintxatzaileen taldeburua
John Agar: Bert Ryan
Harry Carey Jr.: Pop Dawson (edo Harry Cary, Jr.)
Gregg Palmer: John Goodfellow
Jim Burk: Soldadua
Dean Smith: James William "Kid" Duffy
Robert Warner: Will Fain
Jeff Wingfield: Billy Devries
Everett Creach: Walt Devries
Roy Jenson: Bainuetxeko kanoilaria, Escondero herrian
Virginia Capers: Delilah
Hank Worden: Hank
Ethan Wayne: Little Jake McCandles
William Walker: Moses Brown
George Fenneman: Narratzailea
Tom Hennesy: Sweet jauna
Chuck Roberson: Texas rangerra


== Kanpo loturak ==
IMDBko fitxa irakurgai (Ingelesez)